**** *****
**** * * *
** *3    *
* *****  *
*** **9* *
***   ****
* ********
*7**  ****
*****  ***
*        *
**1** ****